8 8 8 8 8 8 8 8 8 8 8 8 6 9 9 6
8 6 6 6 6 6 6 6 6 6 6 6 6 9 9 6
8 6 1 1 1 1 1 1 1 6 6 6 6 9 9 6
8 6 1 9 9 9 9 9 9 9 9 6 6 9 9 6
8 6 1 9 9 9 9 9 1 6 9 6 6 9 9 6
8 6 1 9 9 9 9 9 1 6 9 6 6 9 9 6
6 6 1 9 9 9 9 9 1 6 9 6 6 9 9 6
6 6 1 9 9 9 9 9 1 6 9 6 6 9 9 6
6 6 1 1 1 9 9 1 1 6 9 6 6 9 9 6
6 6 6 6 1 9 9 1 6 6 9 9 9 9 9 6
6 6 6 6 1 9 9 1 6 6 6 6 6 6 6 6
6 6 6 6 1 9 9 1 6 6 6 6 6 6 6 6