4 4 4 4 4 4 4 4 4 4 4 4 4 4 4 4 4 4 4 4 4 4 4 4 4 4 4 4 4 4 4 4 4 4 4 4 4 4 4 4 4 4 4 4 4 4 4 4 4 4
4 4 4 4 4 4 4 4 4 4 4 4 4 4 4 4 4 4 4 4 4 4 4 4 4 4 4 4 4 4 4 4 4 4 4 4 4 4 4 4 4 4 4 4 4 4 4 4 4 4
4 4 4 4 4 4 4 4 4 4 4 4 4 4 4 4 4 4 4 4 4 4 4 4 4 4 4 4 4 4 4 4 4 4 4 4 4 4 4 4 4 4 4 4 4 4 4 4 4 4
6 6 6 6 6 6 6 6 6 6 6 6 6 6 6 6 6 6 6 6 6 6 6 6 6 6 6 6 6 6 6 6 6 6 6 6 6 6 6 6 6 6 6 6 6 6 6 6 6 6
0 0 0 0 0 9 9 9 9 0 0 0 0 0 6 6 6 6 6 6 6 6 6 6 6 6 6 0 0 9 9 9 9 9 9 9 9 9 9 9 0 0 0 0 0 0 0 0 0 0
0 0 0 0 9 9 9 9 9 9 0 0 0 0 0 0 0 0 0 0 0 0 0 0 0 0 0 0 0 9 6 6 6 6 6 6 6 6 6 9 0 0 0 0 0 9 9 9 9 0
0 0 0 0 9 9 9 9 9 9 9 9 9 9 9 0 0 0 0 0 0 0 0 0 0 0 0 9 9 9 9 6 6 6 6 6 6 6 6 9 0 0 0 0 0 9 0 9 9 0
0 0 0 0 9 9 9 9 9 9 0 0 0 0 9 0 0 0 0 0 0 0 0 0 0 0 0 9 9 9 9 0 0 0 0 0 0 0 0 9 0 0 0 0 0 9 0 0 0 0
0 0 0 0 0 9 9 9 9 0 0 0 0 0 9 0 0 9 9 9 9 9 0 0 0 0 0 9 9 9 9 0 0 0 0 0 0 0 0 9 0 0 0 0 0 9 0 0 0 0
0 0 0 0 0 0 0 9 0 0 0 0 0 0 9 0 9 9 9 0 0 9 0 0 0 0 0 0 9 0 0 0 0 0 0 0 0 0 0 9 0 0 0 9 9 9 9 0 0 0
0 0 0 0 0 0 9 9 0 0 0 0 0 0 9 9 9 9 9 0 0 9 0 0 0 0 0 0 9 0 0 0 0 0 0 0 0 0 0 9 9 9 9 9 9 9 9 0 0 0
0 0 0 0 0 9 9 0 0 0 0 0 0 0 9 9 9 9 0 0 0 9 0 0 0 0 0 9 9 0 0 0 0 0 0 0 0 0 0 0 0 0 0 9 9 9 9 0 0 0
0 0 0 0 9 9 0 8 8 0 0 0 0 0 0 0 0 0 0 0 0 9 0 0 0 0 0 9 0 0 0 0 0 0 0 0 0 0 0 0 0 0 0 0 0 0 0 0 0 0
0 0 0 0 9 0 0 8 8 0 0 0 0 0 0 0 0 0 8 8 0 9 0 0 0 9 9 9 0 0 0 0 0 0 0 0 0 8 0 0 0 0 0 0 0 0 0 0 0 0
0 0 0 0 9 0 0 8 8 8 8 8 8 8 8 8 8 8 8 8 0 9 0 0 0 9 0 0 0 0 0 0 0 0 0 0 0 8 0 0 0 0 0 0 0 0 0 0 0 0
0 0 0 0 9 0 0 8 8 0 0 0 0 0 0 0 0 0 8 8 0 9 0 0 0 9 9 0 0 0 0 0 0 0 0 0 0 8 0 0 0 0 0 0 0 0 0 0 0 0
0 0 0 0 9 0 0 0 0 0 0 0 0 0 0 0 0 0 0 0 0 9 0 0 0 0 9 0 0 0 0 0 8 8 8 8 8 8 0 0 0 0 0 0 0 9 9 9 0 0
0 0 0 0 9 0 0 0 0 0 0 0 0 0 0 0 0 0 9 9 9 9 0 0 0 0 9 9 9 0 0 0 8 0 0 0 0 0 0 0 0 0 0 9 9 9 9 9 0 0
0 0 0 0 9 0 0 0 0 0 0 0 0 0 0 0 0 0 9 0 0 0 0 0 0 0 0 0 9 0 0 0 8 0 0 0 0 0 0 0 0 9 9 9 0 9 9 9 0 0
0 0 0 9 9 9 9 9 9 0 0 0 0 0 0 0 0 0 9 0 0 0 0 0 0 0 0 0 9 0 0 0 8 0 0 0 0 0 0 0 0 9 0 0 0 0 0 0 0 0
0 0 0 9 9 9 9 9 9 0 0 0 0 0 0 0 0 0 9 9 9 9 9 9 9 9 9 9 9 0 0 8 8 0 0 0 0 0 0 9 9 9 0 0 0 0 0 0 0 0
0 0 6 9 9 9 9 9 9 6 6 6 0 0 0 0 0 0 0 0 0 1 1 1 1 1 1 1 0 0 0 8 0 0 0 0 0 0 0 9 0 0 0 0 0 0 0 0 0 0
0 0 6 6 6 9 6 6 6 6 0 0 0 0 0 0 0 0 0 0 0 1 1 9 9 9 9 1 1 0 0 8 0 0 0 0 0 0 0 9 9 9 9 9 9 0 0 0 0 0
0 0 6 6 6 9 6 6 6 6 0 0 0 0 0 0 0 0 0 1 1 1 1 9 9 9 9 1 1 0 0 0 0 0 0 0 0 0 0 0 0 0 0 0 9 0 0 0 0 0
0 0 6 6 6 9 9 9 9 9 9 0 0 0 0 0 0 0 1 9 9 9 9 9 9 9 9 1 1 0 0 0 0 0 0 0 0 0 0 0 0 0 0 0 9 0 0 0 2 2
0 0 0 0 0 0 0 0 0 0 9 0 0 0 0 0 0 1 1 9 1 1 1 9 9 9 9 1 1 0 0 0 0 0 0 0 0 0 0 0 0 0 0 0 9 0 0 0 2 2
0 0 0 0 0 0 0 0 0 0 9 0 0 0 0 0 1 1 1 9 1 1 1 1 1 1 1 1 1 0 0 0 0 0 0 9 9 9 9 9 0 0 0 0 9 9 9 2 2 2
0 0 0 0 0 0 0 0 0 6 9 6 6 6 6 6 6 6 6 9 1 1 1 9 9 9 1 1 1 0 0 0 0 0 9 9 9 9 9 9 0 0 0 0 0 0 9 2 2 2
0 0 0 0 0 0 0 0 6 6 9 9 9 9 9 9 9 9 9 9 1 1 9 9 9 9 1 1 0 0 0 0 0 0 9 9 9 9 9 9 0 0 0 0 0 0 9 2 2 2
0 0 0 0 0 0 0 0 6 6 9 6 6 6 6 6 6 6 6 9 1 1 9 1 9 9 1 1 0 0 0 0 0 0 0 0 9 0 0 0 0 0 0 0 0 0 9 2 2 2
0 0 0 0 0 0 0 0 6 6 9 6 6 6 6 6 6 6 6 9 1 1 9 1 1 1 1 1 0 0 0 0 0 0 0 0 9 0 0 0 0 0 0 0 0 0 9 2 2 2
0 0 0 0 0 0 0 0 6 6 9 6 6 6 6 6 6 6 6 9 1 9 9 9 9 1 1 1 0 9 9 9 9 0 0 0 9 0 0 0 0 0 0 0 0 0 9 2 2 2
0 0 0 0 0 0 0 0 6 6 9 6 6 6 6 6 6 0 0 9 9 9 9 9 9 1 1 1 0 9 9 9 9 9 9 9 9 0 0 0 0 0 0 0 9 9 9 9 2 2
0 0 0 0 0 0 0 0 0 6 9 6 6 6 6 6 6 0 0 1 1 9 9 9 9 1 1 0 0 9 9 9 9 0 0 0 0 0 0 0 0 0 0 0 9 9 9 9 2 2
0 0 0 0 0 0 0 0 0 6 9 9 6 6 6 6 6 0 0 1 1 9 9 9 9 9 9 9 9 9 9 9 9 0 0 0 0 0 0 0 0 0 0 0 9 9 9 9 2 2
0 0 0 0 0 0 0 0 0 6 6 9 9 6 6 0 0 0 0 1 1 1 1 1 1 1 1 0 0 9 9 9 9 0 0 0 0 0 0 0 0 0 0 0 9 9 9 9 2 2
0 0 0 0 0 0 0 0 0 6 6 6 9 6 0 0 0 0 0 1 1 1 1 1 1 1 0 0 0 9 9 9 9 0 0 0 0 0 0 0 0 0 0 9 9 9 9 0 2 2
0 0 0 0 0 0 0 0 0 6 6 6 9 0 0 0 0 0 0 1 1 1 1 0 0 0 0 0 0 0 0 0 0 0 0 0 0 0 0 0 0 0 0 9 9 9 9 0 0 0
0 0 0 0 0 0 6 6 9 9 9 9 9 9 9 0 0 0 0 0 0 0 0 0 0 0 0 0 0 0 0 0 0 0 0 0 0 0 0 0 0 0 0 9 9 9 9 0 0 0
0 0 0 0 6 6 6 6 9 9 9 9 9 9 9 9 9 9 0 0 0 0 0 0 0 0 0 0 0 0 0 0 0 0 0 0 0 0 0 0 0 0 0 0 0 9 0 0 0 0
0 0 0 0 6 6 6 6 9 9 9 9 9 9 9 0 0 9 9 0 0 0 0 0 0 0 0 0 0 0 0 0 0 0 0 0 0 0 0 0 0 0 0 0 0 9 0 0 0 0
0 0 0 0 6 6 6 6 6 6 9 0 0 0 0 0 0 0 9 0 0 0 0 0 0 0 0 0 0 0 0 0 0 0 1 1 9 9 9 9 9 9 9 9 9 9 0 0 0 0
0 0 0 6 6 6 6 6 6 6 9 0 0 0 0 0 0 0 9 0 0 0 0 0 0 0 0 0 0 0 0 0 0 1 1 1 9 1 0 0 0 0 0 0 0 0 0 0 0 0
0 0 6 6 6 6 6 6 6 6 9 0 0 0 0 0 0 0 9 0 0 0 0 0 0 0 0 0 1 1 1 1 1 1 1 1 9 1 0 0 0 0 0 0 0 0 0 0 0 0
0 0 6 6 6 6 6 6 6 9 9 0 0 0 0 0 0 0 9 0 0 0 9 9 9 9 9 9 9 1 1 1 1 1 1 1 9 1 0 0 0 0 0 0 0 0 0 0 0 0
0 0 6 6 6 6 6 6 6 9 0 0 0 0 0 0 0 0 9 9 9 9 9 9 9 9 9 9 9 9 9 9 9 9 9 9 9 1 0 0 0 0 0 0 0 0 0 0 0 0
0 9 9 9 6 6 9 9 9 9 0 0 0 0 0 0 0 0 0 0 0 0 9 9 9 9 9 9 9 1 1 1 1 1 1 1 1 1 1 0 0 0 0 0 0 0 0 0 0 0
0 9 9 9 9 9 9 6 6 6 0 0 0 0 0 0 0 0 0 0 0 0 0 0 0 0 0 0 0 1 1 1 1 1 1 1 1 1 1 0 0 0 0 0 0 0 0 0 0 0
0 9 9 9 6 6 6 6 6 6 0 0 0 0 0 0 0 0 0 0 0 0 0 0 0 0 0 0 0 0 0 0 0 0 0 0 0 0 0 0 0 0 0 0 0 0 0 0 0 0
0 0 0 0 6 6 6 6 6 6 0 0 0 0 0 0 0 0 0 0 0 0 0 0 0 0 0 0 0 0 0 0 0 0 0 0 0 0 0 0 0 0 0 0 0 0 0 0 0 0